0,0,0,0,0,0,0,0,0,0,0,0,0
0,0,0,0,0,0,0,0,0,0,0,0,0
0,0,0,0,0,0,0,0,0,0,0,0,0
0,0,0,0,0,0,0,0,0,0,0,0,0
s,s,s,s,s,s,s,s,s,s,s,s,s
r,r,r,r,r,r,r,r,r,r,r,r,r
y,y,y,y,y,y,y,y,y,y,y,y,y
b,b,b,b,b,b,b,b,b,b,b,b,b
p,p,p,p,p,p,p,p,p,p,p,p,p
g,g,g,g,g,g,g,g,g,g,g,g,g
0,0,0,0,0,0,0,0,0,0,0,0,0
0,0,0,0,0,0,0,0,0,0,0,0,0
0,0,0,0,0,0,0,0,0,0,0,0,0
0,0,0,0,0,0,0,0,0,0,0,0,0
0,0,0,0,0,0,0,0,0,0,0,0,0
0,0,0,0,0,0,0,0,0,0,0,0,0
0,0,0,0,0,0,0,0,0,0,0,0,0
0,0,0,0,0,0,0,0,0,0,0,0,0