0,$,0,0,0,0,0,0,0,0,0,0,0
0,0,0,0,0,0,0,0,0,0,0,0,0
0,$,0,0,0,0,0,0,0,0,0,0,0
0,$,0,0,0,0,0,0,0,0,0,0,0
0,$,0,0,0,0,0,0,0,0,0,0,0
0,$,0,0,0,0,0,b,0,0,0,0,0
0,$,0,0,0,0,b,c,b,0,0,0,0
0,$,0,0,0,b,c,w,c,b,0,0,0
0,$,0,0,b,c,w,c,w,c,b,0,0
0,$,0,b,c,w,c,s,c,w,c,b,0
0,$,0,0,b,c,w,c,w,c,b,0,0
0,$,0,0,0,b,c,w,c,b,0,0,0
0,$,0,0,0,0,b,c,b,0,0,0,0
0,$,0,0,0,0,0,b,0,0,0,0,0
0,$,0,0,0,0,0,0,0,0,0,0,0
0,$,0,0,0,0,0,0,0,0,0,0,0
0,$,0,0,0,0,0,0,0,0,0,0,0
0,$,$,$,$,$,$,$,$,$,$,$,$