0,0,0,0,0,0,0,0,0,0,0,0,0
0,0,0,0,0,0,0,0,0,0,0,0,0
0,0,0,0,0,0,0,0,0,0,0,0,0
0,0,0,0,0,0,0,0,0,0,0,0,0
$,$,$,$,$,$,$,$,$,$,$,$,$
0,0,0,0,$,0,0,0,0,0,$,p,0
0,$,w,0,$,0,0,0,0,0,$,0,0
0,$,0,0,$,0,0,$,0,0,$,0,0
0,$,0,0,$,g,0,$,0,0,$,0,0
0,$,0,0,$,0,0,$,0,0,$,0,0
0,$,0,o,$,0,0,$,0,b,$,0,0
0,$,0,0,$,0,0,$,0,0,$,0,0
0,$,0,0,$,0,0,$,0,0,$,0,0
0,$,0,0,$,0,r,$,0,0,$,0,0
0,$,0,0,$,0,0,$,0,0,$,0,0
0,$,c,0,0,0,0,$,0,0,0,0,0
0,$,0,0,0,0,0,$,0,0,0,0,y
0,$,$,$,$,$,$,$,$,$,$,$,$
