0,0,0,0,0,0,0,0,0,0,0,0,0
0,0,0,0,0,0,0,0,0,0,0,0,0
0,0,0,0,0,0,0,0,0,0,0,0,0
0,0,0,0,0,0,0,0,0,0,0,0,0
b,b,b,b,b,b,b,b,b,b,b,b,b
$,0,0,0,0,0,0,0,0,0,0,0,$
b,b,b,b,b,b,b,b,b,b,b,b,b
0,0,0,0,0,0,0,0,0,0,0,0,0
o,s,s,s,s,s,s,s,s,s,s,s,o
$,0,0,0,0,0,0,0,0,0,0,0,$
w,w,w,w,w,w,w,w,w,w,w,w,w
0,0,0,0,0,0,0,0,0,0,0,0,0
c,s,s,s,s,s,s,s,s,s,s,s,c
$,0,0,0,0,0,0,0,0,0,0,0,$
r,r,r,r,r,r,r,r,r,r,r,r,r
0,0,0,0,0,0,0,0,0,0,0,0,0
r,r,r,r,r,r,r,r,r,r,r,r,r
$,0,0,0,0,0,0,0,0,0,0,0,$
