0,0,0,0,0,0,0,0,0,0,0,0,0
0,0,0,0,0,0,0,0,0,0,0,0,0
0,0,0,0,0,0,0,0,0,0,0,0,0
0,0,0,0,0,0,0,0,0,0,0,0,0
0,0,0,0,0,0,0,0,0,0,0,0,0
c,w,$,c,c,c,c,c,c,c,$,w,c
c,w,y,$,c,c,c,c,c,$,g,w,c
c,w,y,y,$,c,c,c,$,g,g,w,c
c,w,y,y,y,$,w,$,g,g,g,w,c
c,w,y,y,y,y,w,g,g,g,g,w,c
c,w,y,y,y,y,w,g,g,g,g,w,c
c,w,y,y,y,y,w,g,g,g,g,w,c
c,s,y,y,y,y,w,g,g,g,g,s,c
c,c,s,y,y,y,w,g,g,g,s,c,c
c,c,c,s,y,y,w,g,g,s,c,c,c
c,c,c,c,s,y,w,g,s,c,c,c,c
c,c,c,c,c,s,w,s,c,c,c,c,c
0,0,0,0,0,0,0,0,0,0,0,0,0
