b,b,b,b,b,b,b,b,b,b,b,b,b
0,0,0,0,0,0,0,0,0,0,0,0,0
0,0,0,0,0,0,0,0,0,0,0,0,0
0,0,0,0,0,0,0,0,0,0,0,0,0
0,0,0,0,0,0,$,0,0,0,0,0,0
0,0,0,0,w,w,0,w,w,0,0,0,0
0,0,w,w,0,0,$,0,0,w,w,0,0
w,w,0,0,o,o,0,o,o,0,0,w,w
0,0,o,o,0,0,$,0,0,o,o,0,0
o,o,0,0,y,y,0,y,y,0,0,o,o
0,0,y,y,0,0,$,0,0,y,y,0,0
y,y,0,0,g,g,0,g,g,0,0,y,y
0,0,g,g,0,0,$,0,0,g,g,0,0
g,g,0,0,r,r,0,r,r,0,0,g,g
0,0,r,r,0,0,$,0,0,r,r,0,0
r,r,0,0,b,b,0,b,b,0,0,r,r
0,0,b,b,0,0,0,0,0,b,b,0,0
b,b,b,b,b,b,b,b,b,b,b,b,b
