0,0,0,0,0,0,0,0,0,0,0,0,0
0,0,0,0,0,0,0,0,0,0,0,0,0
0,0,0,0,0,0,0,0,0,0,0,0,0
0,0,0,0,0,0,0,0,0,0,0,0,0
0,0,0,0,0,0,s,0,0,0,0,0,0
0,0,0,b,b,b,s,g,g,g,0,0,0
0,0,b,b,b,w,w,w,g,g,g,0,0
0,0,b,b,w,w,w,w,w,g,g,0,0
0,b,b,b,w,w,w,w,w,g,g,g,0
0,b,b,b,w,w,w,w,w,g,g,g,0
0,b,b,b,w,w,w,w,w,g,g,g,0
0,s,0,0,s,0,s,0,s,0,0,s,0
0,0,0,0,0,0,s,0,0,0,0,0,0
0,0,0,0,0,0,s,0,0,0,0,0,0
0,0,0,0,0,0,s,0,0,0,0,0,0
0,0,0,0,$,0,$,0,0,0,0,0,0
0,0,0,0,$,$,$,0,0,0,0,0,0
0,0,0,0,0,$,0,0,0,0,0,0,0