0,0,0,0,0,0,0,0,0,0,0,0,0
0,0,0,0,0,0,0,0,0,0,0,0,0
0,0,0,0,0,0,0,0,0,0,0,0,0
0,0,0,0,0,0,0,0,0,0,0,0,0
o,0,$,y,y,y,y,y,y,y,$,0,o
o,0,$,$,y,y,y,y,y,$,$,0,o
o,0,$,0,$,y,y,y,$,0,$,0,o
o,0,$,0,p,$,y,$,c,0,$,0,o
o,0,$,0,p,0,s,0,c,0,$,0,o
o,0,$,0,p,0,g,0,c,0,$,0,o
o,0,$,0,p,0,g,0,c,0,$,0,o
o,0,$,0,p,0,g,0,c,0,$,0,o
o,0,$,0,p,0,g,0,c,0,$,0,o
o,$,$,$,p,0,g,0,c,$,$,$,o
0,0,0,0,0,0,0,0,0,0,0,0,0
0,0,0,0,0,0,0,0,0,0,0,0,0
0,0,0,0,0,0,0,0,0,0,0,0,0
0,0,0,0,0,0,0,0,0,0,0,0,0
