0,0,0,0,0,0,0,0,0,0,0,0,0
0,0,0,0,0,0,0,0,0,0,0,0,0
w,0,0,0,0,0,0,0,0,0,0,0,0
w,o,0,0,0,0,0,0,0,0,0,0,0
w,o,c,0,0,0,0,0,0,0,0,0,0
w,o,c,g,0,0,0,0,0,0,0,0,0
w,o,c,g,r,0,0,0,0,0,0,0,0
w,o,c,g,r,b,0,0,0,0,0,0,0
w,o,c,g,r,b,p,0,0,0,0,0,0
w,o,c,g,r,b,p,y,0,0,0,0,0
w,o,c,g,r,b,p,y,w,0,0,0,0
w,o,c,g,r,b,p,y,w,o,0,0,0
w,o,c,g,r,b,p,y,w,o,c,0,0
w,o,c,g,r,b,p,y,w,o,c,g,0
s,s,s,s,s,s,s,s,s,s,s,s,r
0,0,0,0,0,0,0,0,0,0,0,0,0
0,0,0,0,0,0,0,0,0,0,0,0,0
0,0,0,0,0,0,0,0,0,0,0,0,0