0,0,0,0,0,0,0,0,0,0,0,0,0
0,0,0,0,0,0,0,0,0,0,0,0,0
0,0,0,0,0,0,0,0,0,0,0,0,0
0,0,0,0,0,0,0,0,0,0,0,0,0
$,w,$,o,$,c,$,g,$,r,$,b,$
$,p,$,s,$,s,$,s,$,s,$,y,$
0,0,0,0,0,0,0,0,0,0,0,0,0
$,p,$,0,$,0,$,0,$,0,$,0,$
$,0,$,p,$,0,$,0,$,0,$,0,$
$,0,$,0,$,p,$,0,$,0,$,0,$
$,0,$,0,$,0,$,p,$,0,$,0,$
$,0,$,0,$,0,$,0,$,p,$,0,$
0,0,0,0,0,0,0,0,0,0,0,p,0
0,0,$,0,$,0,$,0,$,p,$,0,0
0,0,$,0,$,0,$,p,$,0,$,0,0
0,0,$,0,$,p,$,0,$,0,$,0,0
0,0,0,p,$,0,$,0,$,0,0,0,0
0,p,0,0,0,0,$,0,0,0,0,0,0
