0,0,0,0,0,0,0,0,0,0,0,0,0
0,0,0,0,0,0,0,0,0,0,0,0,0
0,0,0,0,0,0,0,0,0,0,0,0,0
0,0,0,0,0,0,0,0,0,0,0,0,0
0,$,o,o,o,o,o,o,o,o,o,$,0
0,$,0,0,0,0,0,0,0,0,0,$,0
0,$,0,$,$,$,$,$,$,$,0,$,0
0,$,0,$,0,0,0,0,0,$,0,$,0
0,$,0,$,0,0,0,0,0,$,0,$,0
0,$,0,$,0,r,r,r,0,$,0,$,0
0,$,0,$,0,g,g,g,0,$,0,$,0
0,$,0,$,0,b,b,b,0,$,0,$,0
0,$,0,$,0,w,w,w,0,$,0,$,0
0,$,0,$,0,0,0,0,0,$,0,$,0
0,$,0,$,c,c,c,c,c,$,0,$,0
0,$,0,0,0,0,0,0,0,0,0,$,0
0,$,0,0,0,0,0,0,0,0,0,$,0
0,$,$,$,$,$,$,$,$,$,$,$,0
