0,0,0,0,0,0,0,0,0,0,0,0,0
0,0,0,0,0,0,0,0,0,0,0,0,0
0,0,0,0,0,0,0,0,0,0,0,0,0
0,0,0,0,0,0,0,0,0,0,0,0,0
y,y,y,y,y,y,y,y,y,y,y,y,y
y,y,y,y,y,y,y,y,y,y,y,y,y
0,0,0,0,0,0,0,0,0,0,0,0,0
r,r,$,0,$,r,r,r,$,0,$,r,r
r,r,$,0,$,r,r,r,$,0,$,r,r
r,r,$,0,$,r,r,r,$,0,$,r,r
r,r,$,0,$,r,r,r,$,0,$,r,r
0,0,0,0,0,0,0,0,0,0,0,0,0
w,w,w,w,w,w,w,w,w,w,w,w,w
w,w,w,w,w,w,w,w,w,w,w,w,w
0,0,0,0,0,0,0,0,0,0,0,0,0
0,0,0,0,0,0,0,0,0,0,0,0,0
0,0,0,0,0,0,0,0,0,0,0,0,0
0,0,0,0,0,0,0,0,0,0,0,0,0
