0,0,0,0,0,0,0,0,0,0,0,0,0
0,0,0,0,0,0,0,0,0,0,0,0,0
0,0,0,0,0,0,0,0,0,0,0,0,0
0,0,0,0,0,0,0,0,0,0,0,0,0
c,c,c,c,c,c,c,c,c,c,c,c,c
0,0,0,0,0,0,0,0,0,0,0,0,0
0,0,s,s,s,0,s,s,s,0,s,s,s
0,0,s,g,s,0,s,g,s,0,s,g,s
0,0,s,s,s,0,s,s,s,0,s,s,s
0,0,0,0,0,0,0,0,0,0,0,0,0
0,s,s,s,0,s,s,s,0,s,s,s,0
0,s,r,s,0,s,r,s,0,s,r,s,0
0,s,s,s,0,s,s,s,0,s,s,s,0
0,0,0,0,0,0,0,0,0,0,0,0,0
s,s,s,0,s,s,s,0,s,s,s,0,0
s,b,s,0,s,b,s,0,s,b,s,0,0
s,s,s,0,s,s,s,0,s,s,s,0,0
0,0,0,0,0,0,0,0,0,0,0,0,0
