0,0,0,0,0,0,0,0,0,0,0,0,0
0,0,0,0,0,0,0,0,0,0,0,0,0
0,0,0,0,0,0,0,0,0,0,0,0,0
0,0,0,0,0,0,0,0,0,0,0,0,0
0,0,0,0,0,0,0,0,0,0,0,0,0
0,0,0,0,0,0,0,0,0,0,0,0,0
0,0,0,0,0,0,0,0,0,0,0,0,0
0,0,0,0,0,w,w,w,0,0,0,0,0
0,0,0,0,0,w,w,w,0,0,0,0,0
0,0,0,0,0,w,w,w,0,0,0,0,0
0,0,0,0,w,w,w,w,w,0,0,0,0
0,0,0,0,w,b,w,b,w,0,0,0,0
0,0,0,w,b,b,w,b,b,w,0,0,0
0,0,0,b,b,b,b,b,b,b,0,0,0
0,0,b,b,b,b,b,b,b,b,b,0,0
0,0,b,b,b,b,b,b,b,b,b,0,0
0,b,b,b,b,b,b,b,b,b,b,b,0
b,b,b,b,b,b,b,b,b,b,b,b,b
