0,0,0,0,0,0,0,0,0,0,0,0,0
0,0,0,0,0,0,0,0,0,0,0,0,0
0,0,0,0,0,0,0,0,0,0,0,0,0
0,0,0,0,0,0,0,0,0,0,0,0,0
r,r,r,r,r,r,r,r,r,r,r,r,r
g,g,g,g,g,g,g,g,g,g,g,g,g
b,b,b,b,b,b,b,b,b,b,b,b,b
$,$,$,$,$,s,s,s,$,$,$,$,$
$,r,r,r,$,0,0,0,$,b,b,b,$
$,r,r,r,$,0,0,0,$,b,b,b,$
$,0,0,0,0,0,0,0,0,0,0,0,$
$,0,0,0,0,0,0,0,0,0,0,0,$
$,0,0,0,$,g,g,g,$,0,0,0,$
$,0,0,0,$,g,g,g,$,0,0,0,$
$,s,s,s,$,$,$,$,$,s,s,s,$
0,0,0,0,0,0,0,0,0,0,0,0,0
0,0,0,0,0,0,0,0,0,0,0,0,0
0,0,0,0,0,0,0,0,0,0,0,0,0
