0,0,0,0,0,0,0,0,0,0,0,0,0
0,0,0,0,0,0,0,0,0,0,0,0,0
0,0,0,0,0,0,0,0,0,0,0,0,0
0,0,0,0,0,0,0,0,0,0,0,0,0
0,0,$,s,s,s,$,0,0,0,0,0,0
0,$,0,0,0,0,0,$,0,0,0,0,0
$,0,0,c,c,c,0,0,$,0,0,0,0
$,0,g,g,g,g,g,0,$,0,0,0,0
$,0,b,b,b,b,b,0,$,0,0,0,0
$,0,0,p,p,p,0,0,$,0,0,0,0
0,$,0,0,0,0,0,$,0,0,0,0,0
0,0,$,$,$,$,$,0,0,0,0,0,0
0,0,0,0,0,0,0,0,0,0,0,0,0
0,0,0,0,0,0,0,0,0,0,0,0,0
0,0,0,0,0,0,0,0,0,0,0,0,0
0,0,0,0,0,0,0,0,0,0,0,0,0
0,0,0,0,0,0,0,0,0,0,0,0,0
0,0,0,0,0,0,0,0,0,0,0,0,0
