0,0,0,0,0,0,0,0,0,0,0,0,0
0,0,0,0,0,0,0,0,0,0,0,0,0
0,0,0,0,0,0,0,0,0,0,0,0,0
0,0,0,0,0,0,0,0,0,0,0,0,0
0,0,0,0,0,0,0,0,0,0,0,0,0
0,0,0,0,0,0,0,0,0,0,0,0,0
0,0,0,0,0,0,0,0,0,0,0,0,0
0,0,0,0,0,0,0,0,0,0,0,0,0
0,0,0,0,0,0,0,0,0,0,0,0,0
0,0,0,0,0,0,0,0,0,0,0,0,0
0,0,0,0,0,0,0,0,0,0,0,0,0
s,s,s,s,s,s,s,s,s,s,s,s,s
y,y,y,y,y,y,y,y,y,y,y,y,y
s,s,s,s,s,s,s,s,s,s,s,s,s
0,0,0,0,0,0,0,0,0,0,0,0,0
s,s,s,s,s,s,s,s,s,s,s,s,s
r,r,r,r,r,r,r,r,r,r,r,r,r
s,s,s,s,s,s,s,s,s,s,s,s,s
