0,0,0,0,0,0,0,0,0,0,0,0,0
0,0,0,0,0,0,0,0,0,0,0,0,0
0,0,0,0,0,0,0,0,0,0,0,0,0
b,b,b,b,b,b,b,b,b,b,b,b,b
b,$,$,$,$,p,$,p,$,$,$,$,b
b,$,0,0,0,0,0,0,0,0,0,$,b
b,$,p,0,0,0,0,0,0,0,p,$,b
b,$,p,p,0,0,0,0,0,p,p,$,b
b,$,p,p,p,0,0,0,p,p,p,$,b
0,b,$,p,p,p,0,p,p,p,$,b,0
0,0,b,$,p,p,p,p,p,$,b,0,0
0,0,0,b,$,p,p,p,$,b,0,0,0
0,0,0,0,b,$,p,$,b,0,0,0,0
0,0,0,0,0,b,p,b,0,0,0,0,0
0,0,0,0,0,0,b,0,0,0,0,0,0
0,0,0,0,0,0,0,0,0,0,0,0,0
0,0,0,0,0,0,0,0,0,0,0,0,0
0,0,0,0,0,0,0,0,0,0,0,0,0
