0,0,0,0,0,0,0,0,0,0,0,0,0
0,0,0,0,0,0,0,0,0,0,0,0,0
0,0,0,0,0,0,0,0,0,0,0,0,0
0,0,0,0,0,0,0,0,0,0,0,0,0
y,y,y,y,y,$,0,$,y,y,y,y,y
p,p,p,p,p,$,0,$,p,p,p,p,p
$,$,w,$,$,$,0,$,$,$,w,$,$
b,b,b,b,b,$,0,$,b,b,b,b,b
r,r,r,r,r,$,0,$,r,r,r,r,r
g,g,g,g,g,$,0,$,g,g,g,g,g
s,s,w,s,s,$,0,$,s,s,w,s,s
c,c,c,c,c,$,0,$,c,c,c,c,c
o,o,o,o,o,$,0,$,o,o,o,o,o
w,w,w,w,w,$,0,$,w,w,w,w,w
0,0,0,0,0,0,0,0,0,0,0,0,0
0,0,0,0,0,0,0,0,0,0,0,0,0
0,0,0,0,0,0,0,0,0,0,0,0,0
0,0,0,0,0,0,0,0,0,0,0,0,0
