0,0,0,0,0,0,0,0,0,0,0,0,0
0,0,0,0,0,0,0,0,0,0,0,0,0
0,0,0,0,0,0,0,0,0,0,0,0,0
0,0,0,0,0,0,0,0,0,0,0,0,0
y,p,0,0,0,0,0,0,0,0,0,0,0
y,p,b,r,0,0,0,0,0,0,0,0,0
y,p,b,r,g,c,0,0,0,0,0,0,0
y,p,b,r,g,c,o,w,0,0,0,0,0
y,p,b,r,g,c,o,w,y,p,0,0,0
s,p,b,r,g,c,o,w,y,p,b,r,0
0,$,s,r,g,c,o,w,y,p,b,r,g
0,0,0,$,s,c,o,w,y,p,b,r,g
0,0,0,0,0,$,s,w,y,p,b,r,g
0,0,0,0,0,0,0,$,s,p,b,r,g
0,0,0,0,0,0,0,0,0,$,s,r,g
0,0,0,0,0,0,0,0,0,0,0,$,s
0,0,0,0,0,0,0,0,0,0,0,0,0
0,0,0,0,0,0,0,0,0,0,0,0,0
