0,0,0,0,0,0,0,0,0,0,0,0,0
0,0,0,0,0,0,0,0,0,0,0,0,0
0,0,0,0,0,0,0,0,0,0,0,0,0
0,0,0,0,0,0,0,0,0,0,0,0,0
g,0,r,0,b,0,p,0,y,0,w,0,o
s,0,s,0,s,0,s,0,s,0,s,0,s
0,b,0,r,0,g,0,c,0,o,0,w,0
0,s,0,s,0,s,0,s,0,s,0,s,0
c,0,g,0,r,0,b,0,p,0,y,0,w
s,0,s,0,s,0,s,0,s,0,s,0,s
0,p,0,b,0,r,0,g,0,c,0,o,0
0,s,0,s,0,s,0,s,0,s,0,s,0
o,0,c,0,g,0,r,0,b,0,p,0,y
s,0,s,0,s,0,s,0,s,0,s,0,s
0,y,0,p,0,b,0,r,0,g,0,c,0
0,s,0,s,0,s,0,s,0,s,0,s,0
w,0,o,0,c,0,g,0,r,0,b,0,p
s,0,s,0,s,0,s,0,s,0,s,0,s
