0,0,0,0,0,0,0,0,0,0,0,0,0
0,0,0,0,0,0,0,0,0,0,0,0,0
0,0,0,0,0,0,0,0,0,0,0,0,0
0,0,0,0,0,0,0,0,0,0,0,0,0
0,0,$,0,$,0,$,0,$,0,$,0,0
0,0,$,0,$,0,$,0,$,0,$,0,0
0,0,$,0,$,0,$,0,$,g,g,0,0
0,0,$,0,$,0,$,0,$,0,$,0,0
0,0,$,0,$,0,$,r,r,r,r,0,0
0,0,$,0,$,0,$,0,$,0,$,0,0
0,0,$,0,$,b,b,b,b,b,b,0,0
0,0,$,0,$,0,$,0,$,0,$,0,0
0,0,$,p,p,p,p,p,p,p,p,0,0
0,0,$,0,$,0,$,0,$,0,$,0,0
0,0,y,y,y,y,y,y,y,y,y,0,0
0,0,s,s,s,s,s,s,s,s,s,0,0
0,0,0,0,0,0,0,0,0,0,0,0,0
0,0,0,0,0,0,0,0,0,0,0,0,0
