0,0,0,0,0,0,0,0,0,0,0,0,0
0,0,0,0,0,0,0,0,0,0,0,0,0
0,0,0,0,0,0,0,0,0,0,0,0,0
0,0,0,0,0,0,0,0,0,0,0,0,0
0,o,c,g,s,b,0,y,w,o,c,g,0
0,c,g,s,b,p,0,w,o,c,g,s,0
0,g,s,b,p,y,0,o,c,g,s,b,0
0,s,b,p,y,w,0,c,g,s,b,p,0
0,b,p,y,w,o,0,g,s,b,p,y,0
0,p,y,w,o,c,0,s,b,p,y,w,0
0,y,w,o,c,g,0,b,p,y,w,o,0
0,w,o,c,g,s,0,p,y,w,o,c,0
0,o,c,g,s,b,0,y,w,o,c,g,0
0,c,g,s,b,p,0,w,o,c,g,s,0
0,g,s,b,p,y,0,o,c,g,s,b,0
0,s,b,p,y,w,0,c,g,s,b,p,0
0,b,p,y,w,o,0,g,s,b,p,y,0
0,p,y,w,o,c,0,s,b,p,y,w,0