0,0,0,0,0,0,0,0,0,0,0,0,0
0,0,0,0,0,0,0,0,0,0,0,0,0
0,0,0,y,0,0,0,0,0,y,0,0,0
0,0,0,y,0,0,0,0,0,y,0,0,0
0,0,0,0,y,0,0,0,y,0,0,0,0
0,0,0,0,y,0,0,0,y,0,0,0,0
0,0,0,s,s,s,s,s,s,s,0,0,0
0,0,0,s,s,s,s,s,s,s,0,0,0
0,0,s,s,r,s,s,s,r,s,s,0,0
0,0,s,s,r,s,s,s,r,s,s,0,0
0,s,s,s,s,s,s,s,s,s,s,s,0
0,s,s,s,s,s,s,s,s,s,s,s,0
0,s,s,s,s,s,s,s,s,s,s,s,0
0,s,0,s,s,s,s,s,s,s,0,s,0
0,s,0,s,0,0,0,0,0,s,0,s,0
0,s,0,s,0,0,0,0,0,s,0,s,0
0,0,0,0,s,s,0,s,s,0,0,0,0
0,0,0,0,s,s,0,s,s,0,0,0,0
