0,0,0,0,0,0,0,0,0,0,0,0,0
0,0,0,0,0,0,0,0,0,0,0,0,0
0,0,0,0,0,0,0,0,0,0,0,0,0
0,0,0,0,0,0,0,0,0,0,0,0,0
b,0,r,0,g,0,c,0,g,0,r,0,b
b,0,r,0,g,0,c,0,g,0,r,0,b
b,0,r,0,g,0,c,0,g,0,r,0,b
b,0,r,0,g,0,c,0,g,0,r,0,b
b,0,r,0,g,0,c,0,g,0,r,0,b
b,0,$,o,$,o,$,o,$,o,$,0,b
b,0,r,0,g,0,c,0,g,0,r,0,b
b,0,r,0,g,0,c,0,g,0,r,0,b
b,0,r,0,g,0,c,0,g,0,r,0,b
b,0,r,0,g,0,c,0,g,0,r,0,b
o,0,o,0,$,0,o,0,$,0,o,0,o
b,0,r,0,g,0,c,0,g,0,r,0,b
0,0,0,0,0,0,0,0,0,0,0,0,0
0,0,0,0,0,0,0,0,0,0,0,0,0