0,0,0,0,0,0,0,0,0,0,0,0,0
0,0,0,0,0,0,0,0,0,0,0,0,0
0,0,0,0,0,0,0,0,0,0,0,0,0
0,0,0,0,0,0,0,0,0,0,0,0,0
0,0,0,0,0,y,y,p,0,0,0,0,0
0,0,0,0,y,y,p,p,b,0,0,0,0
0,0,0,y,y,p,p,b,b,r,0,0,0
0,0,0,y,p,p,b,b,r,r,0,0,0
0,0,y,p,p,b,b,r,r,g,g,0,0
0,0,p,p,b,b,r,r,g,g,c,0,0
0,0,p,b,b,r,r,g,g,c,c,0,0
0,0,b,b,r,r,g,g,c,c,o,0,0
0,0,b,r,r,g,g,c,c,o,o,0,0
0,0,r,r,g,g,c,c,o,o,w,0,0
0,0,0,g,g,c,c,o,o,w,0,0,0
0,0,0,g,c,c,o,o,w,w,0,0,0
0,0,0,0,c,o,o,w,w,0,0,0,0
0,0,0,0,0,o,w,w,0,0,0,0,0
