0,0,0,0,0,0,0,0,0,0,0,0,0
0,0,0,0,0,0,0,0,0,0,0,0,0
0,$,0,$,0,0,0,0,0,$,0,$,0
0,$,g,$,0,0,0,0,0,$,g,$,0
0,$,c,$,0,0,0,0,0,$,c,$,0
0,$,$,$,0,0,0,0,0,$,$,$,0
0,0,0,0,0,0,0,0,0,0,0,0,0
0,0,0,0,p,w,w,w,y,0,0,0,0
0,0,0,0,p,o,o,o,y,0,0,0,0
0,0,0,0,p,c,c,c,y,0,0,0,0
0,0,0,0,p,g,g,g,y,0,0,0,0
0,0,0,0,p,r,r,r,y,0,0,0,0
0,0,0,0,p,b,b,b,y,0,0,0,0
0,0,0,0,0,0,0,0,0,0,0,0,0
0,0,0,0,0,0,0,0,0,0,0,0,0
0,0,0,0,0,0,0,0,0,0,0,0,0
0,0,0,0,0,0,0,0,0,0,0,0,0
0,0,0,0,0,0,0,0,0,0,0,0,0